{
  "spawn": [
    {
      "x": 400,
      "y": 400
    }
  ],
  "walls": [
    {
      "x1": 384,
      "y1": 384,
      "x2": 384,
      "y2": 448
    },
    {
      "x1": 384,
      "y1": 448,
      "x2": 480,
      "y2": 448
    },
    {
      "x1": 384,
      "y1": 384,
      "x2": 448,
      "y2": 320
    },
    {
      "x1": 448,
      "y1": 320,
      "x2": 448,
      "y2": 288
    },
    {
      "x1": 480,
      "y1": 256,
      "x2": 480,
      "y2": 448
    },
    {
      "x1": 480,
      "y1": 256,
      "x2": 384,
      "y2": 256
    },
    {
      "x1": 384,
      "y1": 384,
      "x2": 384,
      "y2": 288
    },
    {
      "x1": 384,
      "y1": 288,
      "x2": 352,
      "y2": 448
    },
    {
      "x1": 384,
      "y1": 256,
      "x2": 384,
      "y2": 224
    },
    {
      "x1": 384,
      "y1": 224,
      "x2": 352,
      "y2": 224
    },
    {
      "x1": 352,
      "y1": 224,
      "x2": 320,
      "y2": 448
    },
    {
      "x1": 320,
      "y1": 448,
      "x2": 256,
      "y2": 448
    },
    {
      "x1": 256,
      "y1": 448,
      "x2": 256,
      "y2": 672
    },
    {
      "x1": 256,
      "y1": 672,
      "x2": 480,
      "y2": 672
    },
    {
      "x1": 480,
      "y1": 672,
      "x2": 480,
      "y2": 448
    },
    {
      "x1": 352,
      "y1": 448,
      "x2": 384,
      "y2": 448
    },
    {
      "x1": 288,
      "y1": 480,
      "x2": 448,
      "y2": 480
    },
    {
      "x1": 448,
      "y1": 480,
      "x2": 448,
      "y2": 640
    },
    {
      "x1": 288,
      "y1": 480,
      "x2": 288,
      "y2": 640
    },
    {
      "x1": 448,
      "y1": 288,
      "x2": 384,
      "y2": 288
    },
    {
      "x1": 288,
      "y1": 640,
      "x2": 320,
      "y2": 640
    },
    {
      "x1": 320,
      "y1": 640,
      "x2": 320,
      "y2": 512
    },
    {
      "x1": 320,
      "y1": 512,
      "x2": 416,
      "y2": 512
    },
    {
      "x1": 416,
      "y1": 512,
      "x2": 416,
      "y2": 640
    },
    {
      "x1": 416,
      "y1": 640,
      "x2": 448,
      "y2": 640
    },
    {
      "x1": 352,
      "y1": 640,
      "x2": 384,
      "y2": 640
    },
    {
      "x1": 384,
      "y1": 640,
      "x2": 384,
      "y2": 544
    },
    {
      "x1": 384,
      "y1": 544,
      "x2": 352,
      "y2": 544
    },
    {
      "x1": 352,
      "y1": 544,
      "x2": 352,
      "y2": 640
    }
  ]
}